111111111111111
1000C000C0000C1
10C111111111001
1C0111111110C01
100111111110001
1P0111111111001
100111111111E01
111111111111111